

NO ./path_no
EA ./path_ea


SO                  ./path_so
WE ./path_we





C 0, 0, 0
F                   255, 255, 255

11111111111111111111111
10000000000000000000001
10000000000000000000001
10000000000000000000001
10000000000N00000000001
10000000000000000000001
10000000000000000000001
10000000000000000000001
10000000000000000000001
11111111111111111111111