

NO ./path_no
EA ./path_ea


SO                  ./path_so
WE ./path_we





C 0,0,0
F 255,255,255


111111
1S001
10001
11111

11
11